"filename", "language", "Java", "comment", "blank", "total"
"c:\Google Drive\4. felev\Szoftver projekt laboratórium\proj-lab\13. Grafikus felület elkészítése\DrukmakoriSivatag\src\GUI\CisternView.java", "Java", 72, 48, 14, 134
"c:\Google Drive\4. felev\Szoftver projekt laboratórium\proj-lab\13. Grafikus felület elkészítése\DrukmakoriSivatag\src\GUI\Controller.java", "Java", 290, 126, 46, 462
"c:\Google Drive\4. felev\Szoftver projekt laboratórium\proj-lab\13. Grafikus felület elkészítése\DrukmakoriSivatag\src\GUI\MechanicView.java", "Java", 60, 29, 14, 103
"c:\Google Drive\4. felev\Szoftver projekt laboratórium\proj-lab\13. Grafikus felület elkészítése\DrukmakoriSivatag\src\GUI\PipeView.java", "Java", 151, 93, 15, 259
"c:\Google Drive\4. felev\Szoftver projekt laboratórium\proj-lab\13. Grafikus felület elkészítése\DrukmakoriSivatag\src\GUI\PumpView.java", "Java", 71, 49, 12, 132
"c:\Google Drive\4. felev\Szoftver projekt laboratórium\proj-lab\13. Grafikus felület elkészítése\DrukmakoriSivatag\src\GUI\SaboteurView.java", "Java", 60, 28, 15, 103
"c:\Google Drive\4. felev\Szoftver projekt laboratórium\proj-lab\13. Grafikus felület elkészítése\DrukmakoriSivatag\src\GUI\SpringView.java", "Java", 69, 44, 12, 125
"c:\Google Drive\4. felev\Szoftver projekt laboratórium\proj-lab\13. Grafikus felület elkészítése\DrukmakoriSivatag\src\GUI\Viewable.java", "Java", 6, 10, 2, 18
"c:\Google Drive\4. felev\Szoftver projekt laboratórium\proj-lab\13. Grafikus felület elkészítése\DrukmakoriSivatag\src\GUI\Window.java", "Java", 88, 48, 17, 153
"c:\Google Drive\4. felev\Szoftver projekt laboratórium\proj-lab\13. Grafikus felület elkészítése\DrukmakoriSivatag\src\GUI\actions\ActionButton.java", "Java", 17, 10, 4, 31
"c:\Google Drive\4. felev\Szoftver projekt laboratórium\proj-lab\13. Grafikus felület elkészítése\DrukmakoriSivatag\src\GUI\actions\BreakPipeButton.java", "Java", 31, 13, 9, 53
"c:\Google Drive\4. felev\Szoftver projekt laboratórium\proj-lab\13. Grafikus felület elkészítése\DrukmakoriSivatag\src\GUI\actions\ChangeFlowButton.java", "Java", 35, 14, 9, 58
"c:\Google Drive\4. felev\Szoftver projekt laboratórium\proj-lab\13. Grafikus felület elkészítése\DrukmakoriSivatag\src\GUI\actions\ConnectPipeButton.java", "Java", 34, 14, 9, 57
"c:\Google Drive\4. felev\Szoftver projekt laboratórium\proj-lab\13. Grafikus felület elkészítése\DrukmakoriSivatag\src\GUI\actions\DisconnectPipeButton.java", "Java", 34, 14, 10, 58
"c:\Google Drive\4. felev\Szoftver projekt laboratórium\proj-lab\13. Grafikus felület elkészítése\DrukmakoriSivatag\src\GUI\actions\FixPipeButton.java", "Java", 32, 14, 8, 54
"c:\Google Drive\4. felev\Szoftver projekt laboratórium\proj-lab\13. Grafikus felület elkészítése\DrukmakoriSivatag\src\GUI\actions\FixPumpButton.java", "Java", 32, 14, 7, 53
"c:\Google Drive\4. felev\Szoftver projekt laboratórium\proj-lab\13. Grafikus felület elkészítése\DrukmakoriSivatag\src\GUI\actions\MakeSlipperyButton.java", "Java", 29, 14, 6, 49
"c:\Google Drive\4. felev\Szoftver projekt laboratórium\proj-lab\13. Grafikus felület elkészítése\DrukmakoriSivatag\src\GUI\actions\MakeStickyButton.java", "Java", 28, 14, 6, 48
"c:\Google Drive\4. felev\Szoftver projekt laboratórium\proj-lab\13. Grafikus felület elkészítése\DrukmakoriSivatag\src\GUI\actions\MoveButton.java", "Java", 31, 15, 7, 53
"c:\Google Drive\4. felev\Szoftver projekt laboratórium\proj-lab\13. Grafikus felület elkészítése\DrukmakoriSivatag\src\GUI\actions\PickupPipeButton.java", "Java", 31, 14, 6, 51
"c:\Google Drive\4. felev\Szoftver projekt laboratórium\proj-lab\13. Grafikus felület elkészítése\DrukmakoriSivatag\src\GUI\actions\PickupPumpButton.java", "Java", 29, 14, 6, 49
"c:\Google Drive\4. felev\Szoftver projekt laboratórium\proj-lab\13. Grafikus felület elkészítése\DrukmakoriSivatag\src\GUI\actions\PlacePipeButton.java", "Java", 31, 14, 6, 51
"c:\Google Drive\4. felev\Szoftver projekt laboratórium\proj-lab\13. Grafikus felület elkészítése\DrukmakoriSivatag\src\GUI\actions\PlacePumpButton.java", "Java", 31, 14, 6, 51
"c:\Google Drive\4. felev\Szoftver projekt laboratórium\proj-lab\13. Grafikus felület elkészítése\DrukmakoriSivatag\src\GUI\menu\ActionPanel.java", "Java", 40, 12, 16, 68
"c:\Google Drive\4. felev\Szoftver projekt laboratórium\proj-lab\13. Grafikus felület elkészítése\DrukmakoriSivatag\src\GUI\menu\InventoryPanel.java", "Java", 104, 23, 22, 149
"c:\Google Drive\4. felev\Szoftver projekt laboratórium\proj-lab\13. Grafikus felület elkészítése\DrukmakoriSivatag\src\GUI\menu\MenuPanel.java", "Java", 42, 28, 12, 82
"c:\Google Drive\4. felev\Szoftver projekt laboratórium\proj-lab\13. Grafikus felület elkészítése\DrukmakoriSivatag\src\GUI\menu\ScorePanel.java", "Java", 53, 21, 16, 90
"c:\Google Drive\4. felev\Szoftver projekt laboratórium\proj-lab\13. Grafikus felület elkészítése\DrukmakoriSivatag\src\model\Cistern.java", "Java", 42, 55, 10, 107
"c:\Google Drive\4. felev\Szoftver projekt laboratórium\proj-lab\13. Grafikus felület elkészítése\DrukmakoriSivatag\src\model\Field.java", "Java", 30, 50, 10, 90
"c:\Google Drive\4. felev\Szoftver projekt laboratórium\proj-lab\13. Grafikus felület elkészítése\DrukmakoriSivatag\src\model\FieldNode.java", "Java", 25, 23, 7, 55
"c:\Google Drive\4. felev\Szoftver projekt laboratórium\proj-lab\13. Grafikus felület elkészítése\DrukmakoriSivatag\src\model\Mechanic.java", "Java", 76, 85, 23, 184
"c:\Google Drive\4. felev\Szoftver projekt laboratórium\proj-lab\13. Grafikus felület elkészítése\DrukmakoriSivatag\src\model\Pipe.java", "Java", 166, 158, 44, 368
"c:\Google Drive\4. felev\Szoftver projekt laboratórium\proj-lab\13. Grafikus felület elkészítése\DrukmakoriSivatag\src\model\Player.java", "Java", 35, 40, 9, 84
"c:\Google Drive\4. felev\Szoftver projekt laboratórium\proj-lab\13. Grafikus felület elkészítése\DrukmakoriSivatag\src\model\Pump.java", "Java", 85, 76, 23, 184
"c:\Google Drive\4. felev\Szoftver projekt laboratórium\proj-lab\13. Grafikus felület elkészítése\DrukmakoriSivatag\src\model\Saboteur.java", "Java", 8, 10, 4, 22
"c:\Google Drive\4. felev\Szoftver projekt laboratórium\proj-lab\13. Grafikus felület elkészítése\DrukmakoriSivatag\src\model\Spring.java", "Java", 15, 17, 4, 36
"c:\Google Drive\4. felev\Szoftver projekt laboratórium\proj-lab\13. Grafikus felület elkészítése\DrukmakoriSivatag\src\model\Tickable.java", "Java", 4, 6, 2, 12
"Total", "-", 2017, 1271, 448, 3736